NO ./map/assets/NO.xpm
SO ./map/assets/SO.xpm
WE ./map/assets/EA.xpm
EA ./map/assets/WE.xpm

F 130,130,130
C 60,60,60

        111111111111111111111111111111111111111111111
        10000000000000000000000000000000000000000000111111
        10000000000000000000000000000000000000000000000001
        10000000000000000000000000000000000000000000111101
        100000000000000000000000000000000000000000001  101
        100000000000000000000000000000000000000000001  101
        1000000000000000000000000000000000000000000001 101
        100000000000000000000000000000000000000000001  101
        100000001111111111111111111111111111100000001  101
        100000001                           100000001  101
        100000001111111111111111111111111111100000001  101
        100000000000000000000000000000000000000000001  101
        100000000000000000000000000000000000000000001  101
        100000000000000000000000000000000000000000001  101
        100000000000000000000000000000000000000000001  101
        100000000000000000000000000000000000000000001  101
        100000000000000000000000000000000000000000001  101
        100000000000000000000000000000000000000000001  101111
1111111110000000000000000000000000000000000011111111   100001
100000000000000000000000000000000000000000001           11101
100000000000000000000000000000000000000000001            1001
111101111000000000000000000000000000000000001           1001
100000001000000000000000000000000000000000001          1001
100000001000000000000000000000000000000000001         1001
100000001000000000000000000000000000000000001         101
1000N0001000000000000000000000000000000000001         101
100000001000000000000000000000000000000000001         101
100000001000000000000000000000000000000000001    11111101
100000001000000000000000000000000000000000001   100000001
101111111111111111111111111111111111111111111111001111111
10000000000000000000000000000000000000000000000001
1111111111111111111111111111111111111111111111111
