11111111111
000000000
11111111111