NO ./assets/north.xpm
SO ./assets/south.xpm
WE ./assets/east.xpm
EA ./assets/west.xpm

F 220,100,0
C 225,30,0

11111111111
10000000001
10000000001
10000001111
10000000001
11100000001
10000000001
10000000001
10000N00001
10000000001
11111111111
